Відправляєш сівішки рекрутам - пдф формат!
summary - якими навичками я володію, що я очікую, люблю працювати над тим, що можна побачити в браузері

margin: 0 auto - вирівняти по центру нашого вікна браузера
vw \ % - відсотки можуть бути до будь якого елементу, будуть братись від батька, а vw від тої області, в якій ми працюємо
20em - 2000% від батька
2ем - в два рази більше від батьківського шрифта
2рем - будуть рахуватись не від батька, а від хтмл (від розміру хтмл тегу)

щоби верстати якісь сайти, не треба знати всі властивості цсс
box-sizing: border-box;  - враховує маргіни, педінги, бордери, щоб вони стали частиною розміру самого елементу
css reset - скидає властивості всередині браузера (не часто використовується)
all: unset - скинути (коли нажали на силку, не нажали)

ВАЖЛИВО! https://developer.mozilla.org/en-US/docs/Web/Guide/CSS/Block_formatting_context

контекст - візуальний блок, який не має якихось рамок, до якого відносяться певні властивості позиціонування. Всі блоки йдуть один за одним - один контекст
Але, можуть бути елементи, які створюють свій власник контекст, або випадають з основного

position: absolute - вирвав бокс з батька (в боксу є власне позиціонування)
position: relative - батьку (всі елементи мають позиціонуватись відповідно до нього)

min-height: мінімальна висотка елементу
max-height: більше цього не може бути


для декоративних - два класи 
всі cv-section - margin-bottom 1.5rem - текст хтмл помножити на 1.5
cv-section-title - h2
columns - колонки

1.для одинакових блоків - одинакові класи
2. для конкретних елементів свої класи, і їх налаштування


display: flex; - створить новий контекст форматування
flex-direction: 

left-side - 35% height 100%
right-side - 3 block - decorative block - flex-direction: column (колонкою) raw (рядком)

fustify-content: space-between - блоки будуть намагатись приліпитись до верху і низу контейнеру

флекс - https://css-tricks.com/snippets/css/a-guide-to-flexbox/

